?=?
*=*
kkya=っきゃ
kkyu=っきゅ
kkyo=っきょ
ggya=っひゃ
ggyu=っひゅ
ggyo=っひょ
ssha=っしゃ
sshu=っしゅ
ssho=っしょ
jja=っじゃ
jju=っじゅ
jjo=っじょ
ccha=っちゃ
cchu=っちゅ
ccho=っちょ
hhya=っひゃ
hhyu=っひゅ
hhyo=っひょ
bbya=っびゃ
bbyu=っびゅ
bbyo=っびょ
ppya=っぴゃ
ppyu=っぴゅ
ppyo=っぴょ
mmya=っみゃ
mmyu=っみゅ
mmyo=っみょ
rrya=っりゃ
rryu=っりゅ
rryo=っりょ
kya=きゃ
kyu=きゅ
kyo=きょ
gya=ぎゃ
gyu=ぎゅ
gyo=ぎょ
sha=しゃ
shu=しゅ
sho=しょ
ja=じゃ
ju=ふ
jo=じょ
cha=ちゃ
chu=ちゅ
cho=ちょ
hya=ひゃ
hyu=ひゅ
hyo=ひょ
bya=びゃ
byu=びゅ
byo=びょ
pya=ぴゃ
pyu=ぴゅ
pyo=ぴょ
mya=みゃ
myu=みゅ
myo=みょ
rya=りゃ
ryu=りゅ
ryo=りょ
kka=っか
kki=っき
kku=っく
kke=っけ
kko=っこ
gga=っが
ggi=っひ
ggu=っぐ
gge=っげ
ggo=っご
ssa=っさ
sshi=っし
ssu=っす
sse=っせ
sso=っそ
zza=っざ
jji=っじ
zzu=っず
zze=っぜ
zzo=っぞ
tta=った
cchi=っち
ttsu=っつ
tte=って
tto=っと
dda=っだ
jji=っじ
zzu=っず
dde=っで
ddo=っど
nna=んあ
nni=んい
nnu=んう
nne=んえ
nno=んお
hha=っは
hhi=っひ
ffu=っふ
hhe=っへ
hho=っほ
bba=っば
bbi=っび
bbu=っぶ
bbe=っべ
bbo=っぼ
ppa=っぱ
ppi=っぴ
ppu=っぷ
ppe=っぺ
ppo=っぽ
mma=っま
mmi=っみ
mmu=っむ
mme=っめ
mmo=っも
yya=っや
yyu=っゆ
yyo=っよ
rra=っら
rri=っり
rru=っる
rre=っれ
rro=っろ
wwa=っわ
ka=か
ki=き
ku=く
ke=け
ko=こ
ga=が
gi=ぎ
gu=ぐ
ge=げ
go=ご
sa=さ
shi=し
su=す
se=せ
so=そ
za=ざ
ji=じ
zu=ず
ze=ぜ
zo=ぞ
ta=た
chi=ち
tsu=つ
te=て
to=と
da=だ
ji=じ
zu=ず
de=で
do=ど
na=な
ni=に
nu=ぬ
ne=ね
no=の
ha=は
hi=ひ
fu=ふ
he=へ
ho=ほ
ba=ば
bi=び
bu=ぶ
be=べ
bo=ぼ
pa=ぱ
pi=ぴ
pu=ぷ
pe=ぺ
po=ぽ
ma=ま
mi=み
mu=む
me=め
mo=も
ya=や
yu=ゆ
yo=よ
ra=ら
ri=り
ru=る
re=れ
ro=ろ
wa=わ
a=あ
i=い
u=う
e=え
o=お
n=ん
n'=ん
nn=ん