?=?
*=*
kkyaa=ッキャー
kkyuu=ッキュー
kkyoo=ッキョー
ggyaa=ッギャー
ggyuu=ッギュー
ggyoo=ッギョー
sshaa=ッシャー
sshuu=ッシュー
sshoo=ッショー
jjaa=ッジャー
jjuu=ッフー
jjoo=ッホー
cchaa=ッチャー
cchuu=ッチュー
cchoo=ッチョー
hhyaa=ッヒャー
hhyuu=ッチュー
hhyoo=ッチョー
bbyaa=ッビャー
bbyuu=ッビュー
bbyoo=ッビョー
ppyaa=ッピャー
ppyuu=ッピュー
ppyoo=ッピョー
mmyaa=ッミャー
mmyuu=ッミュー
mmyoo=ッミョー
rryaa=ッリャー
rryuu=ッリュー
rryoo=ッリョー
kkya=ッキャ
kkyu=ッキュ
kkyo=ッキョ
ggya=ッギャ
ggyu=ッギュ
ggyo=ッギョ
ssha=ッシャ
sshu=ッシュ
ssho=ッショ
jja=ッジャ
jju=ッジュ
jjo=ッジョ
ccha=ッチャ
cchu=ッチュ
ccho=ッチョ
hhya=ッヒャ
hhyu=ッヒュ
hhyo=ッヒョ
bbya=ッビャ
bbyu=ッビュ
bbyo=ッビョ
ppya=ッピャ
ppyu=ッピュ
ppyo=ッピョ
mmya=ッミャ
mmyu=ッミュ
mmyo=ッミョ
rrya=ッリャ
rryu=ッリュ
rryo=ッリョ
kyaa=キャー
kyuu=キュー
kyoo=キョー
gyaa=ガアー
gyuu=ギュー
gyoo=ギョー
shaa=シャー
shuu=シュー
shoo=ショー
jaa=ジャー
juu=フー
joo=ジョー
chaa=チャー
chuu=チュー
choo=チョー
hyaa=ヒャー
hyuu=ヒュー
hyoo=ヒョー
byaa=ビャー
byuu=ビュー
byoo=ビョー
pyaa=ピャー
pyuu=ピュー
pyoo=ピョー
myaa=ミャー
myuu=ミュー
myoo=ミョー
ryaa=リャー
ryuu=リュー
ryoo=リョー
kya=キャ
kyu=キュ
kyo=キョ
gya=ギャ
gyu=ギュ
gyo=ギョ
sha=シャ
shu=シュ
sho=ショ
ja=ジャ
ju=ジュ
jo=ジョ
cha=チャ
chu=チュ
cho=チョ
hya=ヒャ
hyu=ヒュ
hyo=ヒョ
bya=ビャ
byu=ビュ
byo=ビョ
pya=ピャ
pyu=ピュ
pyo=ピョ
mya=ミャ
myu=ミュ
myo=ミョ
rya=リャ
ryu=リュ
ryo=リョ
kkaa=ッカー
kkii=ッキー
kkuu=ックー
kkee=ッケー
kkoo=ッコー
ggaa=ッガー
ggii=ッギー
gguu=ッグー
ggee=ッゲー
ggoo=ッゴー
ssaa=ッサー
sshii=ッシー
ssuu=ッスー
ssee=ッセー
ssoo=ッソー
zzaa=ッザー
jjii=ッジー
zzuu=ッズー
zzee=ッゼー
zzoo=ッゾー
ttaa=ッター
cchii=ッチー
ttsuu=ッツー
ttee=ッテー
ttoo=ッヨー
ddaa=ッダー
jjii=ッジー
zzuu=ッズー
ddee=ッデー
ddoo=ッドー
nnaa=ッナー
nnii=ッニー
nnuu=ッヌー
nnee=ッネー
nnoo=ッノー
hhaa=ッハー
hhii=ッヒー
ffuu=ッフー
hhee=ッヘー
hhoo=ッホー
bbaa=ッバー
bbii=ッビー
bbuu=ッブー
bbee=ッベー
bboo=ッボー
ppaa=ッパー
ppii=ッピー
ppuu=ップー
ppee=ッペー
ppoo=ッポー
mmaa=ッマー
mmii=ッミー
mmuu=ッムー
mmee=ッメー
mmoo=ッモー
yyaa=ッヤー
yyuu=ッユー
yyoo=ッヨー
rraa=ッラー
rrii=ッリー
rruu=ッルー
rree=ッレー
rroo=ッロー
wwaa=ッワー
kka=ッカ
kki=ッキ
kku=ック
kke=ッケ
kko=ッコ
gga=ッガ
ggi=ッギ
ggu=ッグ
gge=ッゲ
ggo=ッゴ
ssa=ッサ
sshi=ッシ
ssu=ッス
sse=ッセ
sso=ッソ
zza=ッザ
jji=ッジ
zzu=ッズ
zze=ッゼ
zzo=ッゾ
tta=ッタ
cchi=ッチ
ttsu=ッツ
tte=ッテ
tto=ット
dda=ッダ
jji=ッジ
zzu=ッズ
dde=ッデ
ddo=ッド
nna=ッナ
nni=ッニ
nnu=ッヌ
nne=ッネ
nno=ッノ
hha=ッハ
hhi=ッヒ
ffu=ッフ
hhe=ッヘ
hho=ッホ
bba=ッバ
bbi=ッビ
bbu=ッブ
bbe=ッベ
bbo=ッボ
ppa=ッパ
ppi=ッピ
ppu=ップ
ppe=ッペ
ppo=ッポ
mma=ッマ
mmi=ッミ
mmu=ッム
mme=ッメ
mmo=ッモ
yya=ッヤ
yyu=ッユ
yyo=ッヨ
rra=ッラ
rri=ッリ
rru=ッル
rre=ッレ
rro=ッロ
wwa=ッワ
kaa=カー
kii=キー
kuu=クー
kee=ケー
koo=コー
gaa=ガー
gii=ギー
guu=グー
gee=ゲー
goo=ゴー
saa=サー
shii=シー
suu=スー
see=セー
soo=ソー
zaa=ザー
jii=ジー
juu=ジュー
zee=ゼー
zoo=ゾー
taa=ター
chii=チー
tsuu=ツー
tee=テー
too=トー
daa=ダー
jii=ジー
zuu=ズー
dee=デー
doo=ドー
naa=ナー
nii=ニー
nuu=ヌー
nee=ネー
noo=ノー
haa=ハー
hii=ヒー
fuu=フー
hee=ヘー
hoo=ホー
baa=バー
bii=ビー
buu=ブー
bee=ベー
boo=ボー
paa=パー
pii=ピー
puu=プー
pee=ペー
poo=ポー
maa=マー
mii=ミー
muu=ムー
mee=メー
moo=モー
yaa=ヤー
yuu=ユー
yoo=ヨー
raa=ラー
rii=リー
ruu=ルー
ree=レー
roo=ロー
waa=ワー
ka=カ
ki=キ
ku=ク
ke=ケ
ko=コ
ga=ガ
gi=ギ
gu=グ
ge=ゲ
go=ゴ
sa=サ
shi=シ
su=ス
se=セ
so=ソ
za=ザ
ji=ジ
zu=ズ
ze=ゼ
zo=ゾ
ta=タ
chi=チ
tsu=ツ
te=テ
to=ト
da=ダ
ji=ジ
zu=ズ
de=デ
do=ド
na=ナ
ni=ニ
nu=ヌ
ne=ネ
no=ノ
ha=ハ
hi=ヒ
fu=フ
he=ヘ
ho=ホ
ba=バ
bi=ビ
bu=ブ
be=ベ
bo=ボ
pa=パ
pi=ピ
pu=プ
pe=ペ
po=ポ
ma=マ
mi=ミ
mu=ム
me=メ
mo=モ
ya=ヤ
yu=ユ
yo=ヨ
ra=ラ
ri=リ
ru=ル
re=レ
ro=ロ
wa=ワ
aa=アー
ii=イー
uu=ウー
ee=エー
oo=オー
a=ア
i=イ
u=ウ
e=エ
o=オ
n=ン
n'=ン
nn=ン