Ja	Я
ja	я
Jo	Ё
jo	ё
Ju	Ю
ju	ю
Ya	Я
ya	я
Yo	Ё
yo	ё
Yu	Ю
yu	ю
'	ъ
a	а
A	А
B	Б
ʙ	б
c	ч
C	Ч
ç	ҷ
Ç	Ҷ
d	д
D	Д
e	е
E	Е
e	э
E	Э
f	ф
F	Ф
g	г
G	Г
ƣ	ғ
Ƣ	Ғ
h	ҳ
H	Ҳ
i	и
I	И
ī	ӣ
Ī	Ӣ
j	й
J	Й
k	к
K	К
l	л
L	Л
m	м
M	М
n	н
N	Н
o	о
O	О
p	п
P	П
q	қ
Q	Қ
r	р
R	Р
s	с
S	С
ş	ш
Ş	Ш
t	т
T	Т
u	у
U	У
ū	ӯ
Ū	Ӯ
v	в
V	В
x	х
X	Х
y	й
Y	Й
z	з
Z	З
ƶ	ж
Ƶ	Ж
